C
CC
CFLAGS
CXX
CXXFLAGS
D
ISO
Makefile
O3
POSIX
REMOTEHOME
ar.Z
ar.bz2
ar.gz
autoconf
autoheader
automake
bz
c99
com
coreutils
dd
dir
email
envfile
example.com
foo
gnupg
gz
hh
hostname
jones
ksh
loaner.example.com
logdirectory
metacharacters
mm
numlib
overridable
posixhosts
s
scp
sh
ss
ssh
stdout
tmp
unbundle
unbundles
unzip
userhost
userhosts
username
v
ver
x.y.z
x.y.z.hostname.yyyy.mm.dd.hh.mm.ss.log
x.y.z.tar.gz
yyyy
