's
envvar
foo
g
gcc
ls
pathfind
s
slocate
stderr
stdout
tmp
usr
v
ver
whereis
